102 32
XXXXXXXXXXXXXXXXXXXXXXXXXXXXXXXXXXXXXXXXXXXXXXXXXXXXXXXXXXXXXXXXXXXXXXXXXXXXXXXXXXXXXXXXXXXXXXXXXXXXXX
X----------------------------------------------------------------------------------------------------X
X----------------------------------------------------------------------------------------------------X
X----------------------------------------------------------------------------------------------------X
X----------------------------------------------------------------------------------------------------X
X----------------------------------------------------------------------------------------------------X
X----------------------------------------------------------------------------------------------------X
X----------------------------------------------------------------------------------------------------X
X----------------------------------------------------------------------------------------------------X
X----------------------------------------------------------------------------------------------------X
X----------------------------------------------------------------------------------------------------X
X----------------------------------------------------------------------------------------------------X
X----------------------------------------------------------------------------------------------------X
X----------------------------------------------------------------------------------------------------X
X----------------------------------------------------------------------------------------------------X
X----------------------------------------------------------------------------------------------------X
X----------------------------------------------------------------------------------------------------X
X----------------------------------------------------------------------------------------------------X
X----------------------------------------------------------------------------------------------------X
X----------------------------------------------------------------------------------------------------X
X----------------------------------------------------------------------------------------------------X
X----------------------------------------------------------------------------------------------------X
X------------------EEE-------EEE-------EEE-------EEE-------EEE-------EEE-------EEE-------EEE-------EEX
X------------------EEE-------EEE-------EEE-------EEE-------EEE-------EEE-------EEE-------EEE-------EEX
X----------------------------------------------------------------------------------------------------X
X----------------------------------------------------------------------------------------------------X
X----------------------------------------------------------------------------------------------------X
X----------------------------------------------------------------------------------------------------X
X----------------------------------------------------------------------------------------------------X
X----------------------------------------------------------------------------------------------------X
X----------------------------------------------------------------------------------------------------X
XXXXXXXXXXXXXXXXXXXXXXXXXXXXXXXXXXXXXXXXXXXXXXXXXXXXXXXXXXXXXXXXXXXXXXXXXXXXXXXXXXXXXXXXXXXXXXXXXXXXXX
