57 81
---------------------------------------------------------
---------------XXXXXXXXXXXXXXXXXXXXXXXXXXXXXXXXX---------
---------------X-------------------------------X---------
---------------X-------------------------------X---------
---------------X-------------------------------X---------
---------------X-------------------------------X---------
---------------X-------------------------------X---------
---------------X-------------------------------X---------
---------------X-------------------------------X---------
---------------X-------------------------------X---------
---------------X-------------------------------X---------
---------------X-------------------------------X---------
---------------X-------------------------------X---------
---------------X-------------------------------X---------
---------------X-------------------------------X---------
---------------X-------------------------------X---------
---------------X-------------------------------X---------
---------------X-------------------------------X---------
---------------X-------------------------------X---------
---------------XXXX--XXX--XXX--XXX--XXX--XX----X---------
---------------XXXX--XXX--XXX--XXX--XXX--XXX---X---------
----------XXXXXXXX---XX---XX---XX---XX---XX----X---------
----------X------------------------------------XXXXXXXX--
----------X-------------------------------------------X--
----------X-------------------------------------------X--
----------X-------------------------------------------X--
----------X-------------------------------------------X--
----------X-------------------------------------------X--
----------X-------------------------------------------X--
----------X-------------------------------------------X--
----------X--------XXXXXXXXXXXXXXXXXXXXXXXXXX---------X--
----------X--------X------------------------X---------X--
----------X--------X------------------------X---------X--
----------X--------X------------------------X---------X--
----------X--------X------------------------X---------X--
----------X--------X------------------------X---------X--
----------X--------X------------------------X---------X--
----------X--------X------------------------X---------X--
----------X--------X------------------------X---------X--
----------X--------X------------------------X---------X--
----------XX-------X------------------------X---------X--
----------XX-------X------------------------X---------X--
---------XXX-------X------------------------XX--------X--
---------XX--------X------------------------XX--------X--
---------XX--------X------------------------XX--------X--
---------XX--------X------------------------XX--------X--
---------XX--------X------------------------XX--------X--
---------XX--------X------------------------XX--------X--
---------XX--------X------------------------XX--------X--
---------XX--------X------------------------XX--------X--
---------XX--------X------------------------XX--------X--
---------XX--------X------------------------XX--------X--
---------XX--------X------------------------XX--------X--
---------XX--------X------------------------XX--------X--
---------XX--------X------------------------XX--------X--
--XXXXXXXXX--------X------------------------XXXX---XXXX--
--X----------------X------------------------XX-------XX--
--X----------------X----------------------XXXX--------X--
--X----------------XXXXXXXXXXXXXXXXXXXXXXXXXX---------X--
--X---------------------------------------------------X--
--X---------------------------------------------------X--
--X---------------------------------------------------X--
--X---------------------------------------------------X--
--X---------------------------------------------------X--
--XXXXXXXXXXXXXXXXXXXXX----XX-------XXXXXXXXXXXXXXXXXXX--
--XXXXXXXXX-XXXXXXXXXXX----XX-------XXXXXXX--------------
----------------------X----XX-------XX-------------------
---------------------XX-------------XX-------------------
----------------------X-------------XX-------------------
----------------------X-------------X--------------------
----------------------X-------------XX-------------------
----------------------X-------------XX-------------------
----------------------X-XXXXXX-XXXX-XX-------------------
----------------------X-X--X-X-XXX--X--------------------
----------------------X-------------X--------------------
----------------------X-------------X--------------------
----------------------X-------------X--------------------
----------------------X-------------X--------------------
----------------------X-------------X--------------------
----------------------XXXXXXXXXXXXXXX--------------------
---------------------------------------------------------
