65 114
XXXXXXXXXXXXXXXXXXXXXXXXXXXXXXXXXXXXXXXXXXXXXXXXXXXXXXXXXXXXXXXXX
X---------------------------------------------------------------X
X---------------------------------------------------------------X
X---------------------------------------------------------------X
X---------------------------------------------------------------X
X---------------------------------------------------------------X
X---------------------------------------------------------------X
X---------------------------------------------------------------X
X---------------------------------------------------------------X
X--------EEGGGEEGGGEEGGGEEGGGEEGGGEEGGGEEGGGEEGGGEEGGGEE--------X
X--------EEGGGEEGGGEEGGGEEGGGEEGGGEEGGGEEGGGEEGGGEEGGGEE--------X
X--------EEGGGEEGGGEEGGGEEGGGEEGGGEEGGGEEGGGEEGGGEEGGGEE--------X
X--------EEGGGEEGGGEEGGGEEGGGEEGGGEEGGGEEGGGEEGGGEEGGGEE--------X
X--------EEGGGEEGGGEEGGGEEGGGEEGGGEEGGGEEGGGEEGGGEEGGGEE--------X
X--------EEGGGEEGGGEEGGGEEGGGEEGGGEEGGGEEGGGEEGGGEEGGGEE--------X
X--------EEGGGEEGGGEEGGGEEGGGEEGGGEEGGGEEGGGEEGGGEEGGGEE--------X
X--------EEGGGEEGGGEEGGGEEGGGEEGGGEEGGGEEGGGEEGGGEEGGGEE--------X
X--------EEGGGEEGGGEEGGGEEGGGEEGGGEEGGGEEGGGEEGGGEEGGGEE--------X
X--------EEGGGEEGGGEEGGGEEGGGEEGGGEEGGGEEGGGEEGGGEEGGGEE--------X
X--------EEGGGEEGGGEEGGGEEGGGEEGGGEEGGGEEGGGEEGGGEEGGGEE--------X
X--------EEGGGEEGGGEEGGGEEGGGEEGGGEEGGGEEGGGEEGGGEEGGGEE--------X
X--------EEGGGEEGGGEEGGGEEGGGEEGGGEEGGGEEGGGEEGGGEEGGGEE--------X
X--------EEGGGEEGGGEEGGGEEGGGEEGGGEEGGGEEGGGEEGGGEEGGGEE--------X
X--------EEGGGEEGGGEEGGGEEGGGEEGGGEEGGGEEGGGEEGGGEEGGGEE--------X
X--------EEGGGEEGGGEEGGGEEGGGEEGGGEEGGGEEGGGEEGGGEEGGGEE--------X
X--------EEGGGEEGGGEEGGGEEGGGEEGGGEEGGGEEGGGEEGGGEEGGGEE--------X
X--------EEGGGEEGGGEEGGGEEGGGEEGGGEEGGGEEGGGEEGGGEEGGGEE--------X
X--------EEGGGEEGGGEEGGGEEGGGEEGGGEEGGGEEGGGEEGGGEEGGGEE--------X
X--------EEGGGEEGGGEEGGGEEGGGEEGGGEEGGGEEGGGEEGGGEEGGGEE--------X
X--------EEGGGEEGGGEEGGGEEGGGEEGGGEEGGGEEGGGEEGGGEEGGGEE--------X
X--------EEGGGEEGGGEEGGGEEGGGEEGGGEEGGGEEGGGEEGGGEEGGGEE--------X
X--------EEGGGEEGGGEEGGGEEGGGEEGGGEEGGGEEGGGEEGGGEEGGGEE--------X
X--------EEGGGEEGGGEEGGGEEGGGEEGGGEEGGGEEGGGEEGGGEEGGGEE--------X
X--------EEGGGEEGGGEEGGGEEGGGEEGGGEEGGGEEGGGEEGGGEEGGGEE--------X
X--------EEGGGEEGGGEEGGGEEGGGEEGGGEEGGGEEGGGEEGGGEEGGGEE--------X
X--------EEGGGEEGGGEEGGGEEGGGEEGGGEEGGGEEGGGEEGGGEEGGGEE--------X
X--------EEGGGEEGGGEEGGGEEGGGEEGGGEEGGGEEGGGEEGGGEEGGGEE--------X
X--------EEGGGEEGGGEEGGGEEGGGEEGGGEEGGGEEGGGEEGGGEEGGGEE--------X
X--------EEGGGEEGGGEEGGGEEGGGEEGGGEEGGGEEGGGEEGGGEEGGGEE--------X
X--------EEGGGEEGGGEEGGGEEGGGEEGGGEEGGGEEGGGEEGGGEEGGGEE--------X
X--------EEGGGEEGGGEEGGGEEGGGEEGGGEEGGGEEGGGEEGGGEEGGGEE--------X
X--------EEGGGEEGGGEEGGGEEGGGEEGGGEEGGGEEGGGEEGGGEEGGGEE--------X
X--------EEGGGEEGGGEEGGGEEGGGEEGGGEEGGGEEGGGEEGGGEEGGGEE--------X
X--------EEGGGEEGGGEEGGGEEGGGEEGGGEEGGGEEGGGEEGGGEEGGGEE--------X
X--------EEGGGEEGGGEEGGGEEGGGEEGGGEEGGGEEGGGEEGGGEEGGGEE--------X
X--------EEGGGEEGGGEEGGGEEGGGEEGGGEEGGGEEGGGEEGGGEEGGGEE--------X
X--------EEGGGEEGGGEEGGGEEGGGEEGGGEEGGGEEGGGEEGGGEEGGGEE--------X
X--------EEGGGEEGGGEEGGGEEGGGEEGGGEEGGGEEGGGEEGGGEEGGGEE--------X
X--------EEGGGEEGGGEEGGGEEGGGEEGGGEEGGGEEGGGEEGGGEEGGGEE--------X
X---------------------------------------------------------------X
X---------------------------------------------------------------X
X---------------------------------------------------------------X
X---------------------------------------------------------------X
X---------------------------------------------------------------X
X---------------------------------------------------------------X
X---------------------------------------------------------------X
X---------------------------------------------------------------X
X--------EEGGGEEGGGEEGGGEEGGGEEGGGEEGGGEEGGGEEGGGEEGGGEE--------X
X--------EEGGGEEGGGEEGGGEEGGGEEGGGEEGGGEEGGGEEGGGEEGGGEE--------X
X--------EEGGGEEGGGEEGGGEEGGGEEGGGEEGGGEEGGGEEGGGEEGGGEE--------X
X--------EEGGGEEGGGEEGGGEEGGGEEGGGEEGGGEEGGGEEGGGEEGGGEE--------X
X--------EEGGGEEGGGEEGGGEEGGGEEGGGEEGGGEEGGGEEGGGEEGGGEE--------X
X--------EEGGGEEGGGEEGGGEEGGGEEGGGEEGGGEEGGGEEGGGEEGGGEE--------X
X--------EEGGGEEGGGEEGGGEEGGGEEGGGEEGGGEEGGGEEGGGEEGGGEE--------X
X--------EEGGGEEGGGEEGGGEEGGGEEGGGEEGGGEEGGGEEGGGEEGGGEE--------X
X--------EEGGGEEGGGEEGGGEEGGGEEGGGEEGGGEEGGGEEGGGEEGGGEE--------X
X--------EEGGGEEGGGEEGGGEEGGGEEGGGEEGGGEEGGGEEGGGEEGGGEE--------X
X--------EEGGGEEGGGEEGGGEEGGGEEGGGEEGGGEEGGGEEGGGEEGGGEE--------X
X--------EEGGGEEGGGEEGGGEEGGGEEGGGEEGGGEEGGGEEGGGEEGGGEE--------X
X--------EEGGGEEGGGEEGGGEEGGGEEGGGEEGGGEEGGGEEGGGEEGGGEE--------X
X--------EEGGGEEGGGEEGGGEEGGGEEGGGEEGGGEEGGGEEGGGEEGGGEE--------X
X--------EEGGGEEGGGEEGGGEEGGGEEGGGEEGGGEEGGGEEGGGEEGGGEE--------X
X--------EEGGGEEGGGEEGGGEEGGGEEGGGEEGGGEEGGGEEGGGEEGGGEE--------X
X--------EEGGGEEGGGEEGGGEEGGGEEGGGEEGGGEEGGGEEGGGEEGGGEE--------X
X--------EEGGGEEGGGEEGGGEEGGGEEGGGEEGGGEEGGGEEGGGEEGGGEE--------X
X--------EEGGGEEGGGEEGGGEEGGGEEGGGEEGGGEEGGGEEGGGEEGGGEE--------X
X--------EEGGGEEGGGEEGGGEEGGGEEGGGEEGGGEEGGGEEGGGEEGGGEE--------X
X--------EEGGGEEGGGEEGGGEEGGGEEGGGEEGGGEEGGGEEGGGEEGGGEE--------X
X--------EEGGGEEGGGEEGGGEEGGGEEGGGEEGGGEEGGGEEGGGEEGGGEE--------X
X--------EEGGGEEGGGEEGGGEEGGGEEGGGEEGGGEEGGGEEGGGEEGGGEE--------X
X--------EEGGGEEGGGEEGGGEEGGGEEGGGEEGGGEEGGGEEGGGEEGGGEE--------X
X--------EEGGGEEGGGEEGGGEEGGGEEGGGEEGGGEEGGGEEGGGEEGGGEE--------X
X--------EEGGGEEGGGEEGGGEEGGGEEGGGEEGGGEEGGGEEGGGEEGGGEE--------X
X--------EEGGGEEGGGEEGGGEEGGGEEGGGEEGGGEEGGGEEGGGEEGGGEE--------X
X--------EEGGGEEGGGEEGGGEEGGGEEGGGEEGGGEEGGGEEGGGEEGGGEE--------X
X--------EEGGGEEGGGEEGGGEEGGGEEGGGEEGGGEEGGGEEGGGEEGGGEE--------X
X--------EEGGGEEGGGEEGGGEEGGGEEGGGEEGGGEEGGGEEGGGEEGGGEE--------X
X--------EEGGGEEGGGEEGGGEEGGGEEGGGEEGGGEEGGGEEGGGEEGGGEE--------X
X--------EEGGGEEGGGEEGGGEEGGGEEGGGEEGGGEEGGGEEGGGEEGGGEE--------X
X--------EEGGGEEGGGEEGGGEEGGGEEGGGEEGGGEEGGGEEGGGEEGGGEE--------X
X--------EEGGGEEGGGEEGGGEEGGGEEGGGEEGGGEEGGGEEGGGEEGGGEE--------X
X--------EEGGGEEGGGEEGGGEEGGGEEGGGEEGGGEEGGGEEGGGEEGGGEE--------X
X--------EEGGGEEGGGEEGGGEEGGGEEGGGEEGGGEEGGGEEGGGEEGGGEE--------X
X--------EEGGGEEGGGEEGGGEEGGGEEGGGEEGGGEEGGGEEGGGEEGGGEE--------X
X--------EEGGGEEGGGEEGGGEEGGGEEGGGEEGGGEEGGGEEGGGEEGGGEE--------X
X--------EEGGGEEGGGEEGGGEEGGGEEGGGEEGGGEEGGGEEGGGEEGGGEE--------X
X--------EEGGGEEGGGEEGGGEEGGGEEGGGEEGGGEEGGGEEGGGEEGGGEE--------X
X---------------------------------------------------------------X
X---------------------------------------------------------------X
X---------------------------------------------------------------X
X---------------------------------------------------------------X
X---------------------------------------------------------------X
X---------------------------------------------------------------X
X---------------------------------------------------------------X
X---------------------------------------------------------------X
X---------------------------------------------------------------X
X--------SSSSSSSSSSSSSSSSSSSSSSSSSSSSSSSSSSSSSSSSSSSSSSS--------X
X--------SSSSSSSSSSSSSSSSSSSSSSSSSSSSSSSSSSSSSSSSSSSSSSS--------X
X--------SSSSSSSSSSSSSSSSSSSSSSSSSSSSSSSSSSSSSSSSSSSSSSS--------X
X--------SSSSSSSSSSSSSSSSSSSSSSSSSSSSSSSSSSSSSSSSSSSSSSS--------X
X---------------------------------------------------------------X
X---------------------------------------------------------------X
X---------------------------------------------------------------X
XXXXXXXXXXXXXXXXXXXXXXXXXXXXXXXXXXXXXXXXXXXXXXXXXXXXXXXXXXXXXXXXX
