108 114
NNNNNNNNNNNNNNNNNNNNNNNNNNNNNNNNNNNNNNNNNNNNNNNNNNNNNNNNNNNNNNNNNNNNNNNNNNNNNNNNNNNNNNNNNNNNNNNNNNNNNNNNNNNN
NNNNNNNNNNNNNNNNNNNNNNNNNNNNNNNNNNNNNNNNNNNNNNNNNNNNNNNNNNNNNNNNNNNNNNNNNNNNNNNNNNNNNNNNNNNNNNNNNNNNNNNNNNNN
NNNNNNNNNNNNNNNNNNNNNNNNNNNNNNNNNNNNNNNNNNNNNNNNNNNNNNNNNNNNNNNNNNNNNNNNNNNNNNNNNNNNNNNNNNNNNNNNNNNNNNNNNNNN
NNNNNNNNNNNNNNNNNNNNNNNNNNNNNNNNNNNNNNNNNNNNNNNNNNNNNNNNNNNNNNNNNNNNNNNNNNNNNNNNNNNNNNNNNNNNNNNNNNNNNNNNNNNN
NNNNNNNNNNNNNNNNNNNNNNNNNNNNNNNNNNNNNNNNNNNNNNNNNNNNNNNNNNNNNNNNNNNNNNNNNNNNNNNNNNNNNNNNNNNNNNNNNNNNNNNNNNNN
NNNNNXXXXXXXXXXXXXXXXXXXXXXXXXXXXXXXXXXXXXXXXXXXXXXXXXXXXXXXXXXXXXXXXXXXXXXXXXXXXXXXXXXXXXXXXXXXXXXXXXXXXXXN
NNNNNXXXXXXXXXXXXXXXXXXXXXXXXXXXXXXXXXXXXXXXXXXXXXXXXXXXXXXXXXXXXXXXXXXXXXXXXXXXXXXXXXXXXXXXXXXXXXXXXXXXXXXN
NNNNNXX-------------------------------------------------------------------------------------------------XXXN
NNNNNXX-------------------------------------------------------------------------------------------------XXXN
NNNNNXX-------------------------------------------------------------------------------------------------XXXN
NNNNNXX-------------------------------------------------------------------------------------------------XXXN
NNNNNXX-------------------------------------------------------------------------------------------------XXXN
NNNNNXX-------------------------------------------------------------------------------------------------XXXN
NNNNNXX-------------------------------------------------------------------------------------------------XXXN
NNNNNXX-------------------------------------------------------------------------------------------------XXXN
NNNNNXX-------------------------------------------------------------------------------------------------XXXN
NNNNNXX-------------------------------------------------------------------------------------------------XXNN
NNNNNXX-------------------------------------------------------------------------------------------------XXNN
NNNNNXX-------------------------------------------------------------------------------------------------XXNN
NNNNNXX-------------------------------------------------------------------------------------------------XXNN
NNNNNXX-------------------------------------------------------------------------------------------------XXNN
NNNNNXX-------------------------------------------------------------------------------------------------XXNN
NNNNNXX-------------------------------------------------------------------------------------------------XXNN
NNNNNXX--------------------XXXXXXXX---------------------------------------------------------------------XXNN
NNNNNXX--------------------XXXXXXXXXXXXXXXXXXXXXXXXXXXXXXXXXXXXXXX--------------------------------------XXNN
NNNNNXX--------------------XXXXXXXXXXXXXXXXXXXXXXXXXXXXXXXXXXXXXXX--------------------------------------XXNN
NNNNNXX--------------------XXNNNNNNNNNNNNNNNNNNNNNNNNNNNNNNNNNNNXX--------------------------------------XXNN
NNNNNXX--------------------XXNNNNNNNNNNNNNNNNNNNNNNNNNNNNNNNNNNNXX--------------------------------------XXNN
NNNNNXX--------------------XXNNNNNNNNNNNNNNNNNNNNNNNNNNNNNNNNNNNXX--------------------------------------XXNN
NNNNNXX--------------------XXNNNNNNNNNNNNNNNNNNNNNNNNNNNNNNNNNNNXX--------------------------------------XXNN
NNNNNXX--------------------XXNNNNNNNNNNNNNNNNNNNNNNNNNNNNNNNNNNNXX--------------------------------------XXNN
NNNNNXX--------------------XXNNNNNNNNNNNNNNNNNNNNNNNNNNNNNNNNNNNXX--------------------------------------XXNN
NNNNNXX--------------------XXNNNNNNNNNNNNNNNNNNNNNNNNNNNNNNNNNNNXX--------------------------------------XXNN
NNNNNXX--------------------XXXXXXXXXXXXXXXXXNNNNNNNNNNNNNNNNNNNNXX--------------------------------------XXNN
NNNNNXX--------------------XXXXXXXXXXXXXXXXXXXXXXXXXXXXXXXXXXXXXXX--------------------------------------XXNN
NNNNNXX-----------------------------XXXXXXXXXXXXXXXXXXXXXXXXXXXXXX--------------------------------------XXNN
NNNNNXX-------------------------------------------------------------------------------------------------XXNN
NNNNNXX-------------------------------------------------------------------------------------------------XXNN
NNNNNXX-------------------------------------------------------------------------------------------------XXNN
NNNNNXX-------------------------------------------------------------------------------------------------XXNN
NNNNNXX-------------------------------------------------------------------------------------------------XXNN
NNNNNXX-------------------------------------------------------------------------------------------------XXNN
NNNNNXX-------------------------------------------------------------------------------------------------XXNN
NNNNNXX-------------------------------------------------------------------------------------------------XXNN
NNNNNXX-------------------------------------------------------------------------------------------------XXNN
NNNNNXX-------------------------------------------------------------------------------------------------XXNN
NNNNNXX-------------------------------------------------------------------------------------------------XXNN
NNNNNXX-------------------------------------------------------------------------------------------------XXNN
NNNNNXX--------------------XXXXXXXXXXXXX----------------------------------------------------------------XXNN
NNNNNXX--------------------XXXXXXXXXXXXXXXXXXXXXXXXXXXXXXXXXXXXXXX--------------------------------------XXNN
NNNNNXX--------------------XXXXXXXXXXXXXXXXXXXXXXXXXXXXXXXXXXXXXXX--------------------------------------XXNN
NNNNNXX--------------------XXNNNNNNNNNNNNNNNNNNNNNNNNNNNNNNNNNNNXX--------------------------------------XXNN
NNNNNXX--------------------XXNNNNNNNNNNNNNNNNNNNNNNNNNNNNNNNNNNNXX--------------------------------------XXNN
NNNNNXX--------------------XXNNNNNNNNNNNNNNNNNNNNNNNNNNNNNNNNNNNXX--------------------------------------XXNN
NNNNNXX--------------------XXNNNNNNNNNNNNNNNNNNNNNNNNNNNNNNNNNNNXX--------------------------------------XXNN
NNNNNXX--------------------XXNNNNNNNNNNNNNNNNNNNNNNNNNNNNNNNNNNNXX--------------------------------------XXNN
NNNNNXX-------------------XXXNNNNNNNNNNNNNNNNNNNNNNNNNNNNNNNNNNNXX--------------------------------------XXNN
NNNNNXX-------------------XXXNNNNNNNNNNNNNNNNNNNNNNNNNNNNNNNNNNNXX--------------------------------------XXNN
NNNNNXX-------------------XXXXXXXXXXXNNNNNNNNNNNNNNNNNNNNNNNNNNNXX--------------------------------------XXNN
NNNNNXX-------------------XXXXXXXXXXXXXXXXXXXXXXXXXXXXXXXXXXXXXXXX--------------------------------------XXNN
NNNNNXX--------------------------XXXXXXXXXXXXXXXXXXXXXXXXXXXXXXXXX--------------------------------------XXNN
NNNNNXX-------------------------------------------------------------------------------------------------XXNN
NNNNNXX-------------------------------------------------------------------------------------------------XXNN
NNNNNXX-------------------------------------------------------------------------------------------------XXNN
NNNNNXX-------------------------------------------------------------------------------------------------XXNN
NNNNNXX-------------------------------------------------------------------------------------------------XXNN
NNNNNXX-------------------------------------------------------------------------------------------------XXNN
NNNNNXX-------------------------------------------------------------------------------------------------XXNN
NNNNNXX-------------------------------------------------------------------------------------------------XXNN
NNNNNXX-------------------------------------------------------------------------------------------------XXNN
NNNNNXX-------------------------------------------------------------------------------------------------XXNN
NNNNNXX-------------------------------------------------------------------------------------------------XXNN
NNNNNXX-------------------------------------------------------------------------------------------------XXNN
NNNNNXX-------------------------------------------------------------------------------------------------XXNN
NNNNNXX-------------------XXXXXXXXXXXXXXXXXXXXXXXXXXXXXXXXXXXXXXXX--------------------------------------XXNN
NNNNNXX-------------------XXXNXXXXXXXXXXXXXXXXXXXXXXXXXXXXXXXXXXXX--------------------------------------XXNN
NNNNNXX-------------------XXXNNNNNNNNNNNNNNNNNNNNNNNNNXXXXXXXXXXXX--------------------------------------XXNN
NNNNNXX-------------------XXXNNNNNNNNNNNNNNNNNNNNNNNNNNNNNNNNNNNXX--------------------------------------XXNN
NNNNNXX-------------------XXXNNNNNNNNNNNNNNNNNNNNNNNNNNNNNNNNNNNXX--------------------------------------XXNN
NNNNNXX-------------------XXXNNNNNNNNNNNNNNNNNNNNNNNNNNNNNNNNNNNXX--------------------------------------XXNN
NNNNNXX-------------------XXXNNNNNNNNNNNNNNNNNNNNNNNNNNNNNNNNNNNXX--------------------------------------XXNN
NNNNNXX-------------------XXXNNNNNNNNNNNNNNNNNNNNNNNNNNNNNNNNNNNXX--------------------------------------XXNN
NNNNNXX-------------------XXXNNNNNNNNNNNNNNNNNNNNNNNNNNNNNNNNNNNXX--------------------------------------XXNN
NNNNNXX-------------------XXXXXXXXXXXXXXXNNNNNNNNNNNNNNNNNNNNNNNXX--------------------------------------XXNN
NNNNNXX-------------------XXXXXXXXXXXXXXXXXXXXXXXXXXXXXXXXXXXXXXXX--------------------------------------XXNN
NNNNNXX------------------------XXXXXXXXXXXXXXXXXXXXXXXXXXXXXXXXXXX--------------------------------------XXNN
NNNNNXX-------------------------------------------------------------------------------------------------XXNN
NNNNXXX-------------------------------------------------------------------------------------------------XXNN
NNNNXXX-------------------------------------------------------------------------------------------------XXNN
NNNNXXX-------------------------------------------------------------------------------------------------XXNN
NNNNXXX-------------------------------------------------------------------------------------------------XXNN
NNNNXXX-------------------------------------------------------------------------------------------------XXNN
NNNNXXX-------------------------------------------------------------------------------------------------XXNN
NNNNXXX-------------------------------------------------------------------------------------------------XXNN
NNNNXXX-------------------------------------------------------------------------------------------------XXNN
NNNNXXX-------------------------------------------------------------------------------------------------XXNN
NNNNXXX-------------------------------------------------------------------------------------------------XXNN
NNNNXXX-------------------------------------------------------------------------------------------------XXNN
NNNNXXX-------------------------------------------------------------------------------------------------XXNN
NNNNXXX-------------------------------------------------------------------------------------------------XXNN
NNNNXXX-------------------------------------------------------------------------------------------------XXNN
NNNNXXX-------------------------------------------------------------------------------------------------XXNN
NNNNXXX-------------------------------------------------------------------------------------------------XXNN
NNNNXXX-------------------------------------------------------------------------------------------------XXNN
NNNNXXXXXXXXXXXXXXXXXXXXXXXXXXXXXXXXXXXXXXXXXXXXXXXXXXXXXXXXXXXXXXXXXXXXXXXXXXXXXXXXXXXXXXXXXXXXXXXXXXXXXXNN
NNNNNXXXXXXXXXXXXXXXXXXXXXXXXXXXXXXXXXXXXXXXXXXXXXXXXXXXXXXXXXXXXXXXXXXXXXXXXXXXXXXXXXXXXXXXXXXXXXXXXXXXXXNN
NNNNNNNNNNNNNNNNNNNNNNNNNNNNNNNNNNNNNNNNNNNNNNNNNNNNNNNNNNNNNNNNNNNNNNNNNNNNNNNNNNNNNNNNNNNNNNNNNNNNNNNNNNNN
NNNNNNNNNNNNNNNNNNNNNNNNNNNNNNNNNNNNNNNNNNNNNNNNNNNNNNNNNNNNNNNNNNNNNNNNNNNNNNNNNNNNNNNNNNNNNNNNNNNNNNNNNNNN
NNNNNNNNNNNNNNNNNNNNNNNNNNNNNNNNNNNNNNNNNNNNNNNNNNNNNNNNNNNNNNNNNNNNNNNNNNNNNNNNNNNNNNNNNNNNNNNNNNNNNNNNNNNN
NNNNNNNNNNNNNNNNNNNNNNNNNNNNNNNNNNNNNNNNNNNNNNNNNNNNNNNNNNNNNNNNNNNNNNNNNNNNNNNNNNNNNNNNNNNNNNNNNNNNNNNNNNNN
NNNNNNNNNNNNNNNNNNNNNNNNNNNNNNNNNNNNNNNNNNNNNNNNNNNNNNNNNNNNNNNNNNNNNNNNNNNNNNNNNNNNNNNNNNNNNNNNNNNNNNNNNNNN
NNNNNNNNNNNNNNNNNNNNNNNNNNNNNNNNNNNNNNNNNNNNNNNNNNNNNNNNNNNNNNNNNNNNNNNNNNNNNNNNNNNNNNNNNNNNNNNNNNNNNNNNNNNN
NNNNNNNNNNNNNNNNNNNNNNNNNNNNNNNNNNNNNNNNNNNNNNNNNNNNNNNNNNNNNNNNNNNNNNNNNNNNNNNNNNNNNNNNNNNNNNNNNNNNNNNNNNNN
XXXXXXXXXXXXXXXXXXXXXXXXXXXXXXXXXXXXXXXXXXXXXXXXXXXXXXXXXXXXXXXXXXXXXXXXXXXXXXXXXXXXXXXXXXXXXXXXXXXXXXXXXXXX
