26 29
XXXXXXXXXXXXXXXXXXXXXXXXXX
XXXXXXXXXXXXXXXXXXXXXXXXXX
XX-----------------------X
XX-----------------------X
XX-----------------------X
XX----XXXXXXXXXXX--------X
XX----XXXXXXXXXXX--------X
XX----XXXXXXXXXXX--------X
XX----XXXXXXXXXXX--------X
XX-----------------------X
XX-----------------------X
XX-----------------------X
XX----XXXXXXXXXXX--------X
XX----XXXXXXXXXXX--------X
XX----XXXXXXXXXXX--------X
XX----XXXXXXXXXXX--------X
XX-----------------------X
XX-----------------------X
XX-----------------------X
XX----XXXXXXXXXXX--------X
XX----XXXXXXXXXXX--------X
XX----XXXXXXXXXXX--------X
XX----XXXXXXXXXXX--------X
XX-----------------------X
XX-----------------------X
XX-----------------------X
XXXXXXXXXXXXXXXXXXXXXXXXXX
XXXXXXXXXXXXXXXXXXXXXXXXXX
XXXXXXXXXXXXXXXXXXXXXXXXXX
