77 77
XXXXXXXXXXXXXXXXNNNNNNNNNNNNNNNNNNNNNNNNNNNNNNNNNNNNNNNNNNNNNNNNNNNNNNNNNNNNN
XXXXXXXXXXXXXXXXXXXXXXXXXXXXXXXXXXXXXXXXXXXXXXXXXXXXXXXXXXXXXXXXXXXXXXXXXXXXX
XXXXXXXXXXXXXXXXXXXXXXXXXXXXXXXXXXXXXXXXXXXXXXXXXXXXXXXXXXXXXXXXXXXXXXXXXXXXX
XXX------------------------------------------------------------------------XX
XXX------------------------------------------------------------------------XX
XXX------------------------------------------------------------------------XX
XXX------------------------------------------------------------------------XX
XXX------------------------------------------------------------------------XX
XXX------------------------------------------------------------------------XX
XXX------------------------------------------------------------------------XX
XXX------------------------------------------------------------------------XX
XXX------------------------------------------------------------------------XX
XXX------------------------------------------------------------------------XX
XXX------------------------------------------------------------------------XX
XXX------------------------------------------------------------------------XX
XXX--------------XXXXXXXXXXXXXXXXXXXXXXXXXXXXXX----------------------------XX
XXX--------------XXXXXXXXXXXXXXXXXXXXXXXXXXXXXX----------------------------XX
XXX--------------XXNNNNNNNNNNNNNNNNNNNNNNNNNNXX----------------------------XX
XXX--------------XXNNNNNNNNNNNNNNNNNNNNNNNNNNXX----------------------------XX
XXX--------------XXNNNNNNNNNNNNNNNNNNNNNNNNNNXX----------------------------XX
XXX--------------XXNNNNNNNNNNNNNNNNNNNNNNNNNNXX----------------------------XX
XXX--------------XXNNNNNNNNNNNNNNNNNNNNNNNNNNXX----------------------------XX
XXX--------------XXXXXXXXXXXXXXXXXXXXXXXXXXXXXX----------------------------XX
XXX--------------XXXXXXXXXXXXXXXXXXXXXXXXXXXXXX----------------------------XX
XXX------------------------------------------------------------------------XX
XXX------------------------------------------------------------------------XX
XXX------------------------------------------------------------------------XX
XXX------------------------------------------------------------------------XX
XXX------------------------------------------------------------------------XX
XXX------------------------------------------------------------------------XX
XXX------------------------------------------------------------------------XX
XXX------------------------------------------------------------------------XX
XXX------------------------------------------------------------------------XX
XXX------------------------------------------------------------------------XX
XXX-------------XXXXXXXXXXXXXXXXXXXXXXXXXXXXXXX----------------------------XX
XXX-------------XXXXXXXXXXXXXXXXXXXXXXXXXXXXXXX----------------------------XX
XXX-------------XXXNNNNNNNNNNNNNNNNNNNNNNNNNNXX----------------------------XX
XXX-------------XXXNNNNNNNNNNNNNNNNNNNNNNNNNNXX----------------------------XX
XXX-------------XXXNNNNNNNNNNNNNNNNNNNNNNNNNNXX----------------------------XX
XXX-------------XXXNNNNNNNNNNNNNNNNNNNNNNNNNNXX----------------------------XX
XXX-------------XXXNNNNNNNNNNNNNNNNNNNNNNNNNNXX----------------------------XX
XXX-------------XXXXXXXXXXXXXXXXXXXXXXXXXXXXXXX----------------------------XX
XXX-------------XXXXXXXXXXXXXXXXXXXXXXXXXXXXXXX----------------------------XX
XXX------------------------------------------------------------------------XX
XXX------------------------------------------------------------------------XX
XXX------------------------------------------------------------------------XX
XXX------------------------------------------------------------------------XX
XXX------------------------------------------------------------------------XX
XXX------------------------------------------------------------------------XX
XXX------------------------------------------------------------------------XX
XXX------------------------------------------------------------------------XX
XXX------------------------------------------------------------------------XX
XXX------------------------------------------------------------------------XX
XXX-------------XXXXXXXXXXXXXXXXXXXXXXXXXXXXXXX----------------------------XX
XXX-------------XXXXXXXXXXXXXXXXXXXXXXXXXXXXXXX----------------------------XX
XXX-------------XXXNNNNNNNNNNNNNNNNNNXXXXXXXXXX----------------------------XX
XXX-------------XXXNNNNNNNNNNNNNNNNNNNNNNNNNNXX----------------------------XX
XXX-------------XXXNNNNNNNNNNNNNNNNNNNNNNNNNNXX----------------------------XX
XXX-------------XXXNNNNNNNNNNNNNNNNNNNNNNNNNNXX----------------------------XX
XXX-------------XXXNNNNNNNNNNNNNNNNNNNNNNNNNNXX----------------------------XX
XXX-------------XXXXXXXXXXXXXXXXXXXXXXXXXXXXXXX----------------------------XX
XXX-------------XXXXXXXXXXXXXXXXXXXXXXXXXXXXXXX----------------------------XX
XXX------------------------------------------------------------------------XX
XXX------------------------------------------------------------------------XX
XXX------------------------------------------------------------------------XX
XXX------------------------------------------------------------------------XX
XXX------------------------------------------------------------------------XX
XXX------------------------------------------------------------------------XX
XXX------------------------------------------------------------------------XX
XXX------------------------------------------------------------------------XX
XXX------------------------------------------------------------------------XX
XXX------------------------------------------------------------------------XX
XXX------------------------------------------------------------------------XX
XXX------------------------------------------------------------------------XX
XXX------------------------------------------------------------------------XX
XXXXXXXXXXXXXXXXXXXXXXXXXXXXXXXXXXXXXXXXXXXXXXXXXXXXXXXXXXXXXXXXXXXXXXXXXXXXX
XXXXXXXXXXXXXXXXXXXXXXXXXXXXXXXXXXXXXXXXXXXXXXXXXXXXXXXXXXXXXXXXXXXXXXXXXXXXX
