38 61
XXXXXXXXXXXXXXXXXXXXXXXXXXXXXXXXXXCCCC
X--------------------------------XCCCC
X--------------------------------XCCCC
X----------------RRCCC-----------XCCCC
X----------------RRCCC-----------XCCCC
X---------------NNNCCC-----------XCCCC
X----------------YYCCC-----------XCCCC
X----------------YYCCC-----------XCLLC
X---------------NNNCCC-----------XCLLC
X----------------GGCCC-----------XCCCC
X----------------GGCCC-----------XCCCC
X---------------NNNCCC-----------XCCCC
X----------------VVCCC-----------XCCCC
X----------------VVCCC-----------XCCCC
X---------------NNNCCC-----------XCCCC
X----------------BBCCC-----------XCCCC
X----------------BBCCC-----------XCCCC
X---------------NNNCCC-----------XCCCC
X----------------PPCCC-----------XCCCC
X----------------PPCCC-----------XCCCC
X---------------NNNCCC-----------XCCCC
X--------------------C-----------XCCCC
X--------------------C-----------XCCCC
X--------------------C-----------XCCCC
X--------------------C-----------XCCCC
X--------------------C-----------XCCCC
X--------------------C-----------XCCCC
X--------------------C-----------XCCCC
X--------------------C-----------XCCCC
X--------------------C-----------XCCCC
X--------------------C-----------XCCCC
X--------------------C-----------XCCCC
X--------------------C-----------XCCCC
X--------------------C-----------XCCCC
X--------------------C-----------XCCCC
X--------------------C-----------XCCCC
X--------------------C-----------XCCCC
X--------------------C-----------XCCCC
X--------------------C-----------XCCCC
X--------------------C-----------XCCCC
X----------------RRCCC-----------XCCCC
X----------------RRCCC-----------XCCCC
X---------------NNNCCC-----------XCCCC
X----------------YYCCC-----------XCCCC
X----------------YYCCC-----------XCTTC
X---------------NNNCCC-----------XCTTC
X----------------GGCCC-----------XCCCC
X----------------GGCCC-----------XCCCC
X---------------NNNCCC-----------XCCCC
X----------------VVCCC-----------XCCCC
X----------------VVCCC-----------XCCCC
X---------------NNNCCC-----------XCCCC
X----------------BBCCC-----------XCCCC
X----------------BBCCC-----------XCCCC
X---------------NNNCCC-----------XCCCC
X----------------PPCCC-----------XCCCC
X----------------PPCCC-----------XCCCC
X--------------------C-----------XCCCC
X--------------------C-----------XCCCC
X--------------------------------XCCCC
XXXXXXXXXXXXXXXXXXXXXXXXXXXXXXXXXXCCCC