34 50
XXXXXXXXXXXXXXXXXXXXXXXXXXXXXXXXXX
X--------------------------------X
X--------------------------------X
X----------------RRCCC-----------X
X----------------RRCCC-----------X
X----------------YYCCC-----------X
X----------------YYCCC-----------X
X----------------GGCCC-----------X
X----------------GGCCC-----------X
X----------------VVCCC-----------X
X----------------VVCCC-----------X
X----------------BBCCC-----------X
X----------------BBCCC-----------X
X----------------PPCCC-----------X
X----------------PPCCC-----------X
X--------------------C-----------X
X--------------------C-----------X
X--------------------C-----------X
X--------------------C-----------X
X--------------------C-----------X
X--------------------C-----------X
X--------------------C-----------X
X--------------------C-----------X
X--------------------C-----------X
X--------------------C-----------X
X--------------------C-----------X
X--------------------C-----------X
X--------------------C-----------X
X--------------------C-----------X
X--------------------C-----------X
X--------------------C-----------X
X--------------------C-----------X
X--------------------C-----------X
X--------------------C-----------X
X----------------RRCCC-----------X
X----------------RRCCC-----------X
X----------------YYCCC-----------X
X----------------YYCCC-----------X
X----------------GGCCC-----------X
X----------------GGCCC-----------X
X----------------VVCCC-----------X
X----------------VVCCC-----------X
X----------------BBCCC-----------X
X----------------BBCCC-----------X
X----------------PPCCC-----------X
X----------------PPCCC-----------X
X--------------------C-----------X
X--------------------C-----------X
X--------------------------------X
XXXXXXXXXXXXXXXXXXXXXXXXXXXXXXXXXX